0 0 2 0 0
5 1 5 5 3
5 1 5 1 1
5 1 5 1 0
5 1 5 1 0
0 0 6 0 0